1,1,2,3,2,3,2,3,2,3,2,3,1,1,1,1,1,1,2,3,2,3,2,3,2,3,2,3,1,1,1,1,1,1,1,1,1,1,1,1,4,5,6,7,6,7,8,9,
10,11,10,11,10,11,10,11,10,11,10,11,1,1,1,1,10,11,10,11,10,11,10,11,10,11,10,11,1,1,1,1,1,1,1,1,1,1,1,1,9,9,5,26,5,27,13,9,
14,15,14,15,14,15,14,15,14,15,14,15,2,3,2,3,14,15,14,15,14,15,14,15,14,15,14,15,2,3,2,3,2,3,2,3,2,3,2,3,9,16,26,26,23,26,13,9,
10,11,19,20,10,11,10,11,10,11,10,11,10,11,10,11,10,11,19,20,10,11,10,11,10,11,10,11,10,11,10,11,10,11,10,11,19,20,19,20,9,5,27,22,5,27,27,9,
14,15,24,25,14,15,14,15,14,15,14,15,14,15,14,15,14,15,24,25,14,15,14,15,14,15,14,15,14,15,14,15,14,15,14,15,24,25,24,25,9,27,27,9,27,27,27,9,
19,20,9,9,19,20,19,20,19,20,19,20,19,20,19,20,19,20,9,9,19,20,19,20,19,20,19,20,19,20,19,20,19,20,19,20,9,9,9,9,9,5,27,9,5,27,13,9,
24,25,28,29,24,25,24,25,24,25,24,25,24,25,24,25,24,25,28,29,24,25,24,25,24,25,24,25,24,25,24,25,24,25,24,25,28,29,9,9,9,26,27,9,26,26,13,9,
30,31,32,33,9,9,30,31,30,31,9,9,30,31,9,9,30,31,32,33,9,9,30,31,30,31,9,9,30,31,9,9,9,9,9,9,32,33,9,9,9,26,27,9,26,35,35,9,
36,37,38,39,40,40,36,37,36,37,40,40,36,37,40,40,36,37,38,39,40,40,36,37,36,37,40,40,36,37,40,40,40,40,41,42,38,39,43,44,45,46,47,40,46,48,18,9