176 26 119
1 2 3 4 5 6 1 2 1 2 3 4 5 6 1 2 1 2 3 4 7 8 1 2 1 2 3 4 5 6 1 2 9 10 3 4 5 6 9 10 1 54 1 54 1 54 1 54 3 4 5 6 11 11 3 4 12 13 1 54 1 54 9 10 3 4 9 10 3 4 9 10 3 4 9 10 3 4 1 54 9 10 1 54 12 13 12 13 1 54 11 11 3 4 14 115 116 16 16 16 16 16 3 4 16 16 16 16 16 16 16 16 17 18 16 16 17 18 16 16 16 16 16 16 16 16 25 25 1 54 1 54 3 4 12 13 1 54 3 4 9 10 1 54 3 4 5 6 19 20 21 22 1 54 23 24 3 4 21 22 1 54 23 24 3 4 21 22 1 54 7 8 9 10 14 115
26 27 3 4 28 29 30 31 32 33 3 4 28 29 30 31 32 33 3 4 7 8 30 31 32 33 3 4 28 29 30 31 26 27 3 4 28 29 11 11 32 33 32 33 32 33 32 33 3 4 35 36 11 11 3 4 32 33 32 33 32 33 26 27 3 4 11 11 3 4 11 11 3 4 11 11 3 4 32 33 11 11 32 33 32 33 32 33 32 33 11 11 3 4 16 69 37 16 16 39 16 16 3 4 16 16 40 16 40 16 40 16 3 4 16 39 3 4 16 16 16 16 40 16 40 16 16 69 32 33 26 27 3 4 32 33 32 33 3 4 11 11 32 33 3 4 28 29 26 27 32 33 41 42 43 44 3 4 45 46 41 42 43 44 3 4 45 46 41 42 7 8 11 11 47 115
12 13 3 4 48 49 9 10 1 2 3 4 48 49 9 10 1 2 3 4 5 6 9 10 1 2 3 4 48 49 9 10 12 13 3 4 48 49 11 11 1 54 51 54 1 54 1 54 3 4 50 51 11 11 3 4 1 2 1 2 1 2 12 13 3 4 11 11 3 4 11 11 3 4 11 11 3 4 1 54 11 11 1 54 1 54 1 54 1 54 11 11 3 4 16 76 37 16 52 53 16 16 17 18 16 16 16 16 16 16 16 16 17 18 52 53 3 4 16 16 16 16 16 16 16 16 16 76 1 54 12 13 3 4 1 54 1 54 3 4 11 11 1 54 3 4 48 49 12 13 1 54 3 4 23 24 3 4 21 22 3 4 23 24 3 4 21 22 3 4 5 6 11 11 14 115
32 33 3 4 35 61 11 11 32 33 3 4 28 60 11 11 32 33 3 4 28 29 11 11 32 33 3 4 28 60 11 11 32 33 3 4 28 29 11 11 32 33 32 33 54 55 56 57 58 59 60 24 62 62 62 62 63 64 65 66 32 33 32 33 3 4 11 11 3 4 11 11 3 4 11 11 3 4 30 31 11 11 32 33 54 55 56 57 62 62 60 61 58 59 16 86 37 16 16 16 16 16 58 59 16 16 16 16 67 68 67 68 3 4 67 68 3 4 16 16 16 39 16 16 16 16 16 86 60 24 62 62 62 62 62 64 65 66 3 4 11 11 32 33 3 4 35 36 32 36 32 33 3 4 32 33 3 4 32 33 3 4 32 33 3 4 30 31 3 4 35 36 11 11 52 69
1 2 3 4 50 49 11 11 1 2 3 4 48 49 11 11 1 2 3 4 48 49 11 11 1 2 3 4 48 49 11 11 1 2 3 4 48 1 11 11 70 54 1 54 1 56 71 15 15 15 15 15 15 15 15 15 25 72 73 74 1 2 1 2 3 4 11 11 3 4 11 11 3 4 11 11 3 4 9 10 11 11 1 54 1 56 71 25 25 25 25 25 25 25 25 25 25 25 25 25 25 25 25 25 16 16 16 16 38 75 38 75 3 4 38 75 3 4 16 16 52 53 25 25 25 25 25 25 25 25 25 25 25 25 25 72 73 24 3 4 11 11 1 54 3 4 50 51 1 51 1 54 3 4 1 54 3 4 1 54 3 4 1 54 3 4 9 10 3 4 50 51 11 11 52 76
32 33 3 4 32 33 11 11 32 33 3 4 35 33 11 11 30 31 3 4 28 60 11 11 32 33 3 4 35 33 11 11 32 33 3 4 28 29 11 11 54 55 56 57 77 71 78 79 3 4 32 33 26 27 3 4 80 81 72 73 60 2 62 62 3 4 11 11 3 4 11 11 3 4 11 11 3 4 26 27 11 11 32 33 56 71 78 79 32 33 32 33 3 4 47 115 116 16 67 68 67 68 41 42 16 16 62 97 16 16 67 68 117 118 117 118 25 25 16 16 62 97 16 16 16 39 98 119 7 8 32 33 41 42 80 81 72 82 62 62 60 24 62 62 62 62 63 64 65 36 32 33 3 4 32 33 3 4 32 33 3 4 32 33 3 4 26 27 3 4 54 55 56 57 52 86
1 2 3 4 1 2 11 11 1 2 3 4 50 2 11 11 9 10 3 4 48 2 11 11 1 2 3 4 50 2 11 11 1 2 3 4 48 49 11 11 70 56 71 15 15 15 87 88 3 4 1 2 12 13 3 4 2 20 15 15 15 15 25 37 3 4 11 11 3 4 11 11 3 4 11 11 3 4 12 13 11 11 1 56 71 89 60 88 1 54 1 54 3 4 14 115 116 16 38 75 38 75 3 4 25 25 25 99 97 16 38 75 118 118 118 118 41 42 25 25 25 99 97 16 52 53 98 119 5 6 1 54 3 4 19 20 25 25 25 25 25 25 25 25 25 25 25 72 73 51 1 54 3 4 1 54 3 4 1 54 3 4 1 54 3 4 12 13 3 4 70 56 71 25 25 25
32 33 3 4 32 33 11 11 30 31 3 4 32 33 11 11 26 27 3 4 35 33 11 11 32 33 3 4 32 33 11 11 26 27 3 4 35 33 54 55 56 71 78 79 30 31 32 33 3 4 32 33 32 33 3 4 32 33 3 4 30 31 30 31 3 4 11 11 3 4 11 11 3 4 11 11 3 4 30 31 54 55 56 71 78 79 30 31 32 33 32 33 3 4 47 115 116 16 16 16 16 16 3 4 67 68 3 4 99 97 16 16 117 118 117 118 3 4 67 68 3 4 99 97 16 16 98 119 35 36 32 33 3 4 36 32 30 31 3 4 26 27 3 4 26 27 80 81 72 73 65 66 3 4 32 33 3 4 32 33 3 4 32 33 3 4 32 33 3 4 56 71 78 79 26 115
1 2 3 4 1 2 11 11 9 10 3 4 1 2 11 11 12 13 3 4 50 2 11 11 1 2 3 4 1 2 11 11 12 13 3 4 50 2 70 56 71 89 60 88 9 10 1 2 3 4 1 2 1 2 3 4 1 2 3 4 9 10 9 10 3 4 11 11 3 4 11 11 3 4 11 11 3 4 9 10 1 56 71 89 60 88 9 10 1 54 1 54 3 4 14 115 116 16 16 16 16 16 17 18 38 75 3 4 93 99 97 16 37 118 118 118 3 4 38 75 3 4 93 99 97 16 98 119 50 51 1 54 3 4 51 54 9 10 3 4 12 13 3 4 12 13 19 20 94 72 73 24 3 4 1 54 3 4 1 54 3 4 1 54 3 4 1 54 3 4 25 37 60 88 14 115
60 61 58 59 60 61 60 61 60 61 58 59 60 61 60 61 60 61 58 59 60 61 60 61 60 61 58 59 60 61 60 61 60 61 58 59 60 61 56 71 60 2 60 2 60 2 60 2 58 59 60 2 60 2 58 59 60 2 58 59 60 2 60 2 58 59 60 61 58 59 60 61 58 59 60 61 58 59 60 61 77 71 60 61 60 61 60 61 60 61 60 61 58 59 95 115 116 16 62 97 16 16 58 59 16 16 58 59 16 93 99 97 37 118 117 118 58 59 62 97 58 59 16 93 99 97 98 119 60 24 60 24 58 59 60 24 60 24 58 59 60 24 58 59 60 24 60 24 60 24 72 82 58 59 60 24 58 59 60 24 58 59 60 24 58 59 60 24 58 59 60 24 60 24 95 115
25 25 25 25 25 25 25 25 25 25 25 25 25 25 25 25 25 25 25 25 25 25 25 25 25 25 25 25 25 25 25 25 25 25 25 25 25 25 25 25 25 25 25 25 25 25 25 25 25 25 25 25 25 25 25 25 25 25 25 25 25 25 25 25 25 25 25 25 25 25 25 25 25 25 25 25 25 25 25 25 25 25 25 25 25 25 25 25 25 25 25 25 25 25 25 25 25 25 25 90 25 25 25 25 25 25 25 25 25 25 25 25 118 118 118 118 25 25 25 90 25 25 25 25 25 25 25 25 25 25 25 25 25 25 25 25 25 25 25 25 25 25 25 25 25 25 25 25 25 25 25 25 25 25 25 25 25 25 25 25 25 25 25 25 25 25 25 25 25 25 25 25 25 25 25 25
37 37 37 37 37 37 37 37 37 37 37 37 37 37 37 37 37 37 37 37 37 37 37 37 37 37 37 37 37 37 37 37 37 37 37 37 37 37 37 37 37 37 37 37 37 37 37 37 37 37 37 37 37 37 37 37 37 37 37 37 37 37 37 37 37 37 37 37 37 37 37 37 37 37 37 37 37 37 37 37 37 37 37 37 37 37 37 37 37 37 37 37 37 37 37 37 37 37 37 37 37 37 37 37 37 37 37 37 37 37 37 37 37 37 37 37 37 37 37 37 37 37 37 37 37 37 37 37 37 37 37 37 37 37 37 37 37 37 37 37 37 37 37 37 37 37 37 37 37 37 37 37 37 37 37 37 37 37 37 37 37 37 37 37 37 37 37 37 37 37 37 37 37 37 37 37
37 37 37 37 37 37 37 37 37 37 37 37 37 37 37 37 37 37 37 37 37 37 37 37 37 37 37 37 37 37 37 37 37 37 37 37 37 37 37 37 37 37 37 37 37 37 37 37 37 37 37 37 37 37 37 37 37 37 37 37 37 37 37 37 37 37 37 37 37 37 37 37 37 37 37 37 37 37 37 37 37 37 37 37 37 37 37 37 37 37 37 37 37 37 37 37 37 37 37 37 37 37 37 37 37 37 37 37 37 37 37 37 37 37 37 37 37 37 37 37 37 37 37 37 37 37 37 37 37 37 37 37 37 37 37 37 37 37 37 37 37 37 37 37 37 37 37 37 37 37 37 37 37 37 37 37 37 37 37 37 37 37 37 37 37 37 37 37 37 37 37 37 37 37 37 37
37 37 37 37 37 37 37 37 37 37 37 37 37 37 37 37 37 37 37 37 37 37 37 37 37 37 37 37 37 37 37 37 37 37 37 37 37 37 37 37 37 37 37 37 37 37 37 37 37 37 37 37 37 37 37 37 37 37 37 37 37 37 37 37 37 37 37 37 37 37 37 37 37 37 37 37 37 37 37 37 37 37 37 37 37 37 37 37 37 37 37 37 37 37 37 37 37 37 37 37 37 37 37 37 37 37 37 37 37 37 37 37 37 37 37 37 37 37 37 37 37 37 37 37 37 37 37 37 37 37 37 37 37 37 37 37 37 37 37 37 37 37 37 37 37 37 37 37 37 37 37 37 37 37 37 37 37 37 37 37 37 37 37 37 37 37 37 37 37 37 37 37 37 37 37 37
37 37 37 37 37 37 37 37 37 37 37 37 37 37 37 37 37 37 37 37 37 37 37 37 37 37 37 37 37 37 37 37 37 37 37 37 37 37 37 37 37 37 37 37 37 37 37 37 37 37 37 37 37 37 37 37 37 37 37 37 37 37 37 37 37 37 37 37 37 37 37 37 37 37 37 37 37 37 37 37 37 37 37 37 37 37 37 37 37 37 37 37 37 37 37 37 37 37 37 37 37 37 37 37 37 37 37 37 37 37 37 37 37 37 37 37 37 37 37 37 37 37 37 37 37 37 37 37 37 37 37 37 37 37 37 37 37 37 37 37 37 37 37 37 37 37 37 37 37 37 37 37 37 37 37 37 37 37 37 37 37 37 37 37 37 37 37 37 37 37 37 37 37 37 37 37
37 37 37 37 37 37 37 37 37 37 37 37 37 37 37 37 37 37 37 37 37 37 37 37 37 37 37 37 37 37 37 37 37 37 37 37 37 37 37 37 37 37 37 37 37 37 37 37 37 37 37 37 37 37 37 37 37 37 37 37 37 37 37 37 37 37 37 37 37 37 37 37 37 37 37 37 37 37 37 37 37 37 37 37 37 37 37 37 37 37 37 37 37 37 37 37 37 37 41 42 16 99 100 37 41 42 37 37 37 37 41 42 37 37 41 42 37 37 3 4 16 99 100 37 37 37 3 4 98 119 37 37 37 37 37 37 37 37 37 37 37 37 37 37 37 37 37 37 37 37 37 37 37 37 37 37 37 37 37 37 37 37 37 37 37 37 37 37 37 37 37 37 37 37 37 37
37 37 37 37 37 37 37 37 37 37 37 37 37 37 37 37 37 37 37 37 37 37 37 37 37 37 37 37 37 37 37 37 37 37 37 37 37 37 37 37 37 37 37 37 37 37 37 37 37 37 37 37 37 37 37 37 37 37 37 37 37 37 37 37 37 37 37 37 37 37 37 37 37 37 37 37 37 37 37 37 37 37 37 37 37 37 37 37 37 37 37 37 37 37 37 37 37 37 3 4 16 16 99 100 3 4 37 37 37 37 3 4 37 37 3 4 37 37 3 4 16 16 99 100 37 37 3 4 98 119 37 37 37 37 37 37 37 37 37 37 37 37 37 37 37 37 37 37 37 37 37 37 37 37 37 37 37 37 37 37 37 37 37 37 37 37 37 37 37 37 37 37 37 37 37 37
37 37 37 37 37 37 37 37 37 37 37 37 37 37 37 37 37 37 37 37 37 37 37 37 37 37 37 37 37 37 37 37 37 37 37 37 37 37 37 37 37 37 37 37 37 37 37 37 37 37 37 37 37 37 37 37 37 37 37 37 37 37 37 37 37 37 37 37 37 37 37 37 37 37 37 37 37 37 37 37 37 37 37 37 37 37 37 37 37 37 37 37 37 37 37 37 37 37 3 4 16 16 16 99 17 18 37 37 37 37 17 18 37 37 3 4 37 37 3 4 16 16 16 99 100 37 3 4 98 119 37 37 37 37 37 37 37 37 37 37 37 37 37 37 37 37 37 37 37 37 37 37 37 37 37 37 37 37 37 37 37 37 37 37 37 37 37 37 37 37 37 37 37 37 37 37
37 37 37 37 37 37 37 37 37 37 37 37 37 37 37 37 37 37 37 37 37 37 37 37 37 37 37 37 37 37 37 37 37 37 37 37 37 37 37 37 37 37 37 37 37 37 37 37 37 37 37 37 37 37 37 37 37 37 37 37 37 37 37 37 37 37 37 37 37 37 37 37 37 37 37 37 37 37 37 37 37 37 37 37 37 37 37 37 37 37 37 37 37 37 37 37 37 37 3 4 16 16 16 16 25 25 37 37 37 37 3 4 37 37 3 4 37 37 3 4 16 16 16 16 99 100 3 4 98 119 37 37 37 37 37 37 37 37 37 37 37 37 37 37 37 37 37 37 37 37 37 37 37 37 37 37 37 37 37 37 37 37 37 37 37 37 37 37 37 37 37 37 37 37 37 37
37 37 37 37 37 37 37 37 37 37 37 37 37 37 37 37 37 37 37 37 37 37 37 37 37 37 37 37 37 37 37 37 37 37 37 37 37 37 37 37 37 37 37 37 37 37 37 37 37 37 37 37 37 37 37 37 37 37 37 37 37 37 37 37 37 37 37 37 37 37 37 37 37 37 37 37 37 37 37 37 37 37 37 37 37 37 37 37 37 37 37 37 37 37 37 37 37 37 17 18 16 16 16 16 41 42 37 37 37 37 17 18 37 37 3 4 37 37 3 4 16 16 16 16 16 99 3 4 98 119 37 37 37 37 37 37 37 37 37 37 37 37 37 37 37 37 37 37 37 37 37 37 37 37 37 37 37 37 37 37 37 37 37 37 37 37 37 37 37 37 37 37 37 37 37 37
37 37 37 37 37 37 37 37 37 37 37 37 37 37 37 37 37 37 37 37 37 37 37 37 37 37 37 37 37 37 37 37 37 37 37 37 37 37 37 37 37 37 37 37 37 37 37 37 37 37 37 37 37 37 37 37 37 37 37 37 37 37 37 37 37 37 37 37 37 37 37 37 37 37 37 37 37 37 37 37 37 37 37 37 37 37 37 37 37 37 37 37 37 37 37 37 37 37 25 25 25 25 25 25 25 25 25 25 25 25 25 25 37 37 25 25 37 37 25 25 25 25 25 25 25 25 25 37 98 119 37 37 37 37 37 37 37 37 37 37 37 37 37 37 37 37 37 37 37 37 37 37 37 37 37 37 37 37 37 37 37 37 37 37 37 37 37 37 37 37 37 37 37 37 37 37
37 37 37 37 37 37 37 37 37 37 37 37 37 37 37 37 37 37 37 37 37 37 37 37 37 37 37 37 37 37 37 37 37 37 37 37 37 37 37 37 37 37 37 37 37 37 37 37 37 37 37 37 37 37 37 37 37 37 37 37 37 37 37 37 37 37 37 37 37 37 37 37 37 37 37 37 37 37 37 37 37 37 37 37 37 37 37 37 37 37 37 37 37 37 37 37 37 37 41 42 101 102 101 102 41 42 103 104 101 101 41 42 37 37 41 42 37 37 41 42 101 102 101 102 101 102 41 42 98 119 37 37 37 37 37 37 37 37 37 37 37 37 37 37 37 37 37 37 37 37 37 37 37 37 37 37 37 37 37 37 37 37 37 37 37 37 37 37 37 37 37 37 37 37 37 37
37 37 37 37 37 37 37 37 37 37 37 37 37 37 37 37 37 37 37 37 37 37 37 37 37 37 37 37 37 37 37 37 37 37 37 37 37 37 37 37 37 37 37 37 37 37 37 37 37 37 37 37 37 37 37 37 37 37 37 37 37 37 37 37 37 37 37 37 37 37 37 37 37 37 37 37 37 37 37 37 37 37 37 37 37 37 37 37 37 37 37 37 37 37 37 37 37 37 3 4 37 37 37 37 3 4 105 106 107 107 3 4 37 37 3 4 37 108 3 4 107 107 37 108 37 37 3 4 25 25 37 37 37 37 37 37 37 37 37 37 37 37 37 37 37 37 37 37 37 37 37 37 37 37 37 37 37 37 37 37 37 37 37 37 37 37 37 37 37 37 37 37 37 37 37 37
37 37 37 37 37 37 37 37 37 37 37 37 37 37 37 37 37 37 37 37 37 37 37 37 37 37 37 37 37 37 37 37 37 37 37 37 37 37 37 37 37 37 37 37 37 37 37 37 37 37 37 37 37 37 37 37 37 37 37 37 37 37 37 37 37 37 37 37 37 37 37 37 37 37 37 37 37 37 37 37 37 37 37 37 37 37 37 37 37 37 37 37 37 37 37 37 37 37 17 18 37 37 37 37 17 18 37 37 107 107 17 18 109 110 3 4 109 110 3 4 107 107 109 110 37 37 3 4 101 102 37 37 37 37 37 37 37 37 37 37 37 37 37 37 37 37 37 37 37 37 37 37 37 37 37 37 37 37 37 37 37 37 37 37 37 37 37 37 37 37 37 37 37 37 37 37
37 37 37 37 37 37 37 37 37 37 37 37 37 37 37 37 37 37 37 37 37 37 37 37 37 37 37 37 37 37 37 37 37 37 37 37 37 37 37 37 37 37 37 37 37 37 37 37 37 37 37 37 37 37 37 37 37 37 37 37 37 37 37 37 37 37 37 37 37 37 37 37 37 37 37 37 37 37 37 37 37 37 37 37 37 37 37 37 37 37 37 37 37 37 37 37 37 37 111 112 111 112 111 112 111 112 111 112 111 112 111 112 111 112 111 112 111 112 111 112 111 112 111 112 111 112 25 25 111 112 37 37 37 37 37 37 37 37 37 37 37 37 37 37 37 37 37 37 37 37 37 37 37 37 37 37 37 37 37 37 37 37 37 37 37 37 37 37 37 37 37 37 37 37 37 37
37 37 37 37 37 37 37 37 37 37 37 37 37 37 37 37 37 37 37 37 37 37 37 37 37 37 37 37 37 37 37 37 37 37 37 37 37 37 37 37 37 37 37 37 37 37 37 37 37 37 37 37 37 37 37 37 37 37 37 37 37 37 37 37 37 37 37 37 37 37 37 37 37 37 37 37 37 37 37 37 37 37 37 37 37 37 37 37 37 37 37 37 37 37 37 37 37 37 113 114 113 114 113 114 113 114 113 114 113 114 113 114 113 114 113 114 113 114 113 114 113 114 113 114 113 114 41 42 113 114 0 0 0 37 37 37 37 37 37 37 37 37 37 37 37 37 37 37 37 37 37 37 37 37 37 37 37 37 37 37 37 37 37 37 37 37 37 37 37 37 37 37 37 37 37 37
