96 11 119
1 2 3 4 5 6 1 2 1 2 3 4 5 6 1 2 1 2 3 4 7 8 1 2 1 2 3 4 5 6 1 2 9 10 3 4 5 6 9 10 1 54 1 54 1 54 1 54 3 4 5 6 11 11 3 4 12 13 1 54 1 54 9 10 3 4 9 10 3 4 9 10 3 4 9 10 3 4 1 54 9 10 1 54 12 13 12 13 1 54 11 11 3 4 14 75
26 27 3 4 28 29 30 31 32 33 3 4 28 29 30 31 32 33 3 4 7 8 30 31 32 33 3 4 28 29 30 31 26 27 3 4 28 29 11 11 32 33 32 33 32 33 32 33 3 4 35 36 11 11 3 4 32 33 32 33 32 33 26 27 3 4 11 11 3 4 11 11 3 4 11 11 3 4 32 33 11 11 32 33 32 33 32 33 32 33 11 11 3 4 16 69
12 13 3 4 48 49 9 10 1 2 3 4 48 49 9 10 1 2 3 4 5 6 9 10 1 2 3 4 48 49 9 10 12 13 3 4 48 49 11 11 1 54 51 54 1 54 1 54 3 4 50 51 11 11 3 4 1 2 1 2 1 2 12 13 3 4 11 11 3 4 11 11 3 4 11 11 3 4 1 54 11 11 1 54 1 54 1 54 1 54 11 11 3 4 16 76
32 33 3 4 35 61 11 11 32 33 3 4 28 60 11 11 32 33 3 4 28 29 11 11 32 33 3 4 28 60 11 11 32 33 3 4 28 29 11 11 32 33 32 33 54 55 56 57 58 59 60 24 62 62 62 62 63 64 65 66 32 33 32 33 3 4 11 11 3 4 11 11 3 4 11 11 3 4 30 31 11 11 32 33 54 55 56 57 62 62 60 61 58 59 16 86
1 2 3 4 50 49 11 11 1 2 3 4 48 49 11 11 1 2 3 4 48 49 11 11 1 2 3 4 48 49 11 11 1 2 3 4 48 1 11 11 70 54 1 54 1 56 71 15 15 15 15 15 15 15 15 15 15 72 73 74 1 2 1 2 3 4 11 11 3 4 11 11 3 4 11 11 3 4 9 10 11 11 1 54 1 56 71 25 25 25 25 25 25 25 25 25
32 33 3 4 32 33 11 11 32 33 3 4 35 33 11 11 30 31 3 4 28 60 11 11 32 33 3 4 35 33 11 11 32 33 3 4 28 29 11 11 54 55 56 57 77 71 78 79 3 4 32 33 26 27 3 4 80 81 72 73 60 2 62 62 3 4 11 11 3 4 11 11 3 4 11 11 3 4 26 27 11 11 32 33 56 71 78 79 32 33 32 33 3 4 47 75
1 2 3 4 1 2 11 11 1 2 3 4 50 2 11 11 9 10 3 4 48 2 11 11 1 2 3 4 50 2 11 11 1 2 3 4 48 49 11 11 70 56 71 15 15 15 87 88 3 4 1 2 12 13 3 4 2 20 15 15 15 15 25 25 3 4 11 11 3 4 11 11 3 4 11 11 3 4 12 13 11 11 1 56 71 89 60 88 1 54 1 54 3 4 14 75
32 33 3 4 32 33 11 11 30 31 3 4 32 33 11 11 26 27 3 4 35 33 11 11 32 33 3 4 32 33 11 11 26 27 3 4 35 33 54 55 56 71 78 79 30 31 32 33 3 4 32 33 32 33 3 4 32 33 3 4 30 31 30 31 3 4 11 11 3 4 11 11 3 4 11 11 3 4 30 31 54 55 56 71 78 79 30 31 32 33 32 33 3 4 47 75
1 2 3 4 1 2 11 11 9 10 3 4 1 2 11 11 12 13 3 4 50 2 11 11 1 2 3 4 1 2 11 11 12 13 3 4 50 2 70 56 71 89 60 88 9 10 1 2 3 4 1 2 1 2 3 4 1 2 3 4 9 10 9 10 3 4 11 11 3 4 11 11 3 4 11 11 3 4 9 10 1 56 71 89 60 88 9 10 1 54 1 54 3 4 14 75
60 61 58 59 60 61 60 61 60 61 58 59 60 61 60 61 60 61 58 59 60 61 60 61 60 61 58 59 60 61 60 61 60 61 58 59 60 61 56 71 60 2 60 2 60 2 60 2 58 59 60 2 60 2 58 59 60 2 58 59 60 2 60 2 58 59 60 61 58 59 60 61 58 59 60 61 58 59 60 61 77 71 60 61 60 61 60 61 60 61 60 61 58 59 95 75
25 25 25 25 25 25 25 25 25 25 25 25 25 25 25 25 25 25 25 25 25 25 25 25 25 25 25 25 25 25 25 25 25 25 25 25 25 25 25 25 25 25 25 25 25 25 25 25 25 25 25 25 25 25 25 25 25 25 25 25 25 25 25 25 25 25 25 25 25 25 25 25 25 25 25 25 25 25 25 25 25 25 25 25 25 25 25 25 25 25 25 25 25 25 25 25
